rows 24
cols 44
players 2
m .....%%%%%........%%..............%%%.......
m ......%%.........%%%....B.......b%%%%.......
m ..%%.......%%.%%.%%%....b..%%.....%%%.bb.%%.
m %%%%%.....%%%%%%%%%%%.....%%......%%.....%%%
m %%%%%%....%%%%%%%%%%..............%%.....%%%
m %%%%%%......%%...%.%%..............%%....%%%
m %..%.%.....................%%%%...........%%
m %%%%%%.........b..........%%%%%%%%......%%%%
m %%%%%.....................%%%%%%%%.....%%%%%
m ..%.......%%%%....%....%%.%%%.%%%%%....%%%%.
m .....aAa.......................%%%..B..%%%..
m .....aaa.............bb........%%%.....%%%%.
m .....aaa.......................%%%%.....%%%.
m .....aaa.......................%%%......%%%.
m .....aaa...%%.............%%%.....%%........
m .....aaa..................%%%...............
m .%..%..%%...%.....%%%.....%%%.b...........%%
m %%%........%%%.....%%%..B..%%.b...........%%
m %%%.......%%%%.....%%.....%%%.b...........%%
m %..%......%%%%....%%%%.....................%
m ..........%%%.....%%%.........bb..%%%%....%%
m ..........%%%.....%%%%%%%%%%%.....%%%%.....%
m ..........%%%......%%.%%%%.%%......%%%....%%
m ..........%%%%....................%%%.....%%
