rows 23
cols 31
players 2

m %%%%%%%%%%%%%%%%%%%%%%%%%%%%%%%
m %%%%%%%%%%%%%%%%%%%%%%%%%%%%%%%
m ..........bB...................
m .....bbbbbbbbbbbbbb............
m ...............................
m ...............................
m ...............................
m ...............................
m ...............................
m ...............................
m ..........bbb..................
m ...............................
m ...............................
m %%%%%..%.%...%%...%..%%%....%%.
m a..........a.........a.........
m .......%..........%............
m ..A............................
m .............aaa...........A...
m aa....................aa.......
m .A........a.a..................
m .......%..........%............
m %%%%%%%%%%%%%%%%%%%%%%%%%%%%%%%
m %%%%%%%%%%%%%%%%%%%%%%%%%%%%%%%