players 2
rows 20
cols 81
m ........%............%%%.......%%...%%%%%%%%%%..........%........................
m .......%...............%%.......%%.%%...A..%%...........%........................
m ...........%%.........................a.................%........................
m %.........%%...........%.....................%%.........%%.......................
m .%.......%..............%%......................................%................
m ..%......%................%%............%.....................%%.................
m ...%......................%%............%........................................
m ..................%.......%%...........%...................................a%....
m ..........................%............%..........%%........................%....
m ...bbb....................%...........%...........%......................A.%%....
m ..bbbbb..................%%.......%%%%%..........%%...................a.%%%%.....
m ..bbbbb...%..............%............%%.aa..a..%%....................%%.........
m ..bbBbb.%%%......%.......%.............%........%................................
m %%%...%%%.......%%......%%....aa...............%%..............aa................
m ..%%%%%.........%........%....................%%.................................
m .....%..........%.........%%%.................%...aa.......%.....................
m ................%...........%%%...............%A...........%%%%%%................
m ...............%..............%...............%%..........%.....%%%............%.
m ................%%............%%..............%%.........%%........%.............
m ........%.......%%%%%..........%.....%%.......%.........%%.........%%............
