rows 14
cols 35
players 2


m %%...........................a...%%
m %%....................a..%.......%%
m %%bbb....................%.a.....%%
m %%Bbb......................A.....%%
m %%bbb...............a.........a..%%
m %%bbb.................a..........%%
m %%bbb.........b.....a...%..a.....%%
m %%bbb......................a.a..A%%
m %%....................%..........%%
m %%.........................a.a...%%
m %%....................%..........%%
m %%.....................%.........%%
m %%.......................%...A...%%
m %%.......................%.......%%