players 2
rows 20
cols 81
m ........%............%%%.......%%...%%%%%%%%%%..........%........................
m .......%...............%%.......%%.%%...B..%%...........%........................
m ...........%%.........................b.................%........................
m %.........%%...........%.....................%%.........%%.......................
m .%.......%..............%%......................................%................
m ..%......%................%%............%.....................%%.................
m ...%......................%%............%........................................
m ..................%.......%%...........%...................................b%....
m ..........................%............%..........%%........................%....
m ...aaa....................%...........%...........%......................B.%%....
m ..aaaaa..................%%.......%%%%%..........%%...................b.%%%%.....
m ..aaaaa...%..............%............%%.bb..b..%%....................%%.........
m ..aaAaa.%%%......%.......%.............%........%................................
m %%%...%%%.......%%......%%....bb...............%%..............bb................
m ..%%%%%.........%........%....................%%.................................
m .....%..........%.........%%%.................%...bb.......%.....................
m ................%...........%%%...............%B...........%%%%%%................
m ...............%..............%...............%%..........%.....%%%............%.
m ................%%............%%..............%%.........%%........%.............
m ........%.......%%%%%..........%.....%%.......%.........%%.........%%............
