rows 23
cols 56
players 2
m ...%%%..............................%%%.................
m .........%%%%....bb......%%%%.....%%....................
m .........%%%%............%%%%.....%%....................
m .%..%....%%%......%%.....%%%.....%%%.......%%....%%.%...
m ..%%%....%...B..........%%%%.....%%%%....%%%%....%%%....
m ..%%%.....%%......bb.......%%....%%%%.....%%.aaaa%%%%...
m ..%%%....%.%.....%.........%.....%%.......%%.aaaaa%%....
m .%%%%b............bb......................%%%Aaaaa%%%...
m .%%%.....................................%%%aaaaa%%%....
m %%%%b.....%%%%%%%%%%%%%%%%%%%%%%%%%%%....%%%%%%%%%%%....
m %%%%%.....%%%%%%%%%%%%%%%%%%%%%%%%%%.....%%%%%%%%%%%....
m .%%%b........%%%%..B..%%.%%%%%%...%%......%%%%%..%.%%...
m ..%%%....................%%%.............%%%............
m ..%%%.....................%%%............%%%............
m ..%%%.....bb.......b......%%%............%%%%...........
m ..%%%.....................%%%............%%%%...........
m .%%%......%.%....%%.%.....%%.....%..%....%%%......%%...%
m .%%%%....%%%......%%%..b..%%......%%%....%%%%.....%%%%%%
m ..%%B....%%%......%%%.....%%%.....%%%.....%%......%%%%%%
m .%%%%....%%%.....%%%.....%..%.....%%%....%.%.....%.%%..%
m ..%%%.....%%%....%%%%............%%%%...................
m ..%%%............%%%%............%%%....................
m .%%%%.............%%%............%%%%...................
