rows 16
cols 28
players 2

m ..a....a.....a....a......a..
m ............................
m ..a....A.....A....A......a..
m ............................
m .............a..............
m ............................
m ............................
m ............................
m ..b....b.....b....b......b..
m ............................
m ..b....B.....B....B......b..
m ............................
m .............b..............
m ............................
m ............................
m ............................