rows 23
cols 56
players 2
m ...%%%..............................%%%.................
m .........%%%%....aa......%%%%.....%%....................
m .........%%%%............%%%%.....%%....................
m .%..%....%%%......%%.....%%%.....%%%.......%%....%%.%...
m ..%%%....%...A..........%%%%.....%%%%....%%%%....%%%....
m ..%%%.....%%......aa.......%%....%%%%.....%%.bbbb%%%%...
m ..%%%....%.%.....%.........%.....%%.......%%.bbbbb%%....
m .%%%%a............aa......................%%%Bbbbb%%%...
m .%%%.....................................%%%bbbbb%%%....
m %%%%a.....%%%%%%%%%%%%%%%%%%%%%%%%%%%....%%%%%%%%%%%....
m %%%%%.....%%%%%%%%%%%%%%%%%%%%%%%%%%.....%%%%%%%%%%%....
m .%%%a........%%%%..A..%%.%%%%%%...%%......%%%%%..%.%%...
m ..%%%....................%%%.............%%%............
m ..%%%.....................%%%............%%%............
m ..%%%.....aa.......a......%%%............%%%%...........
m ..%%%.....................%%%............%%%%...........
m .%%%......%.%....%%.%.....%%.....%..%....%%%......%%...%
m .%%%%....%%%......%%%..a..%%......%%%....%%%%.....%%%%%%
m ..%%A....%%%......%%%.....%%%.....%%%.....%%......%%%%%%
m .%%%%....%%%.....%%%.....%..%.....%%%....%.%.....%.%%..%
m ..%%%.....%%%....%%%%............%%%%...................
m ..%%%............%%%%............%%%....................
m .%%%%.............%%%............%%%%...................
