rows 24
cols 44
players 2
m .....%%%%%........%%..............%%%.......
m ......%%.........%%%....A.......a%%%%.......
m ..%%.......%%.%%.%%%....a..%%.....%%%.aa.%%.
m %%%%%.....%%%%%%%%%%%.....%%......%%.....%%%
m %%%%%%....%%%%%%%%%%..............%%.....%%%
m %%%%%%......%%...%.%%..............%%....%%%
m %..%.%.....................%%%%...........%%
m %%%%%%.........a..........%%%%%%%%......%%%%
m %%%%%.....................%%%%%%%%.....%%%%%
m ..%.......%%%%....%....%%.%%%.%%%%%....%%%%.
m .....bBb.......................%%%..A..%%%..
m .....bbb.............aa........%%%.....%%%%.
m .....bbb.......................%%%%.....%%%.
m .....bbb.......................%%%......%%%.
m .....bbb...%%.............%%%.....%%........
m .....bbb..................%%%...............
m .%..%..%%...%.....%%%.....%%%.a...........%%
m %%%........%%%.....%%%..A..%%.a...........%%
m %%%.......%%%%.....%%.....%%%.a...........%%
m %..%......%%%%....%%%%.....................%
m ..........%%%.....%%%.........aa..%%%%....%%
m ..........%%%.....%%%%%%%%%%%.....%%%%.....%
m ..........%%%......%%.%%%%.%%......%%%....%%
m ..........%%%%....................%%%.....%%
