rows 14
cols 35
players 2


m .............................a.....
m ......................a............
m ..bbb......................a.......
m ..Bbb......................A.......
m ..bbb...............a.........a....
m ..bbb..............................
m ..bbb...............a......a.......
m ..bbb......................a.a.....
m ...................................
m ..........a................a.a.....
m ...................................
m ...................................
m ............a.a............A.......
m ...................................